{
    "name": "Gnarly",
    "author": "kthakore",
    "wheels": [
                { "x" : 100, "y" : 300 },
                { "x" : 220, "y" : 150 },
                { "x" : 400, "y" :  50 },
                { "x" : 600, "y" : 150 },
                { "x" : 500, "y" : 350 },
                { "x" : 200, "y" : 450 },
                { "x" : 300, "y" : 300 }
            ],
    "starting_wheel": 1
}
