{
    "name": "square",
    "author": "garu",
    "wheels": [
                { "x" :  60, "y" : 288 },
                { "x" : 280, "y" : 288 },
                { "x" : 520, "y" : 288 },
                { "x" : 740, "y" : 288 },

                { "x" : 209, "y" : 178 },
                { "x" : 399, "y" : 178 },
                { "x" : 589, "y" : 178 },

                { "x" : 304, "y" :  68 },
                { "x" : 494, "y" :  68 },

                { "x" : 170, "y" : 398 },
                { "x" : 390, "y" : 398 },
                { "x" : 610, "y" : 398 },

                { "x" : 280, "y" : 508 },
                { "x" : 500, "y" : 508 }
        ],
    "starting_wheel": 1
}
