{
    "name": "square",
    "author": "garu",
    "wheels": [
                { "x" :  60, "y" : 288 },
                { "x" : 280, "y" : 288 },
                { "x" : 520, "y" : 288 },
                { "x" : 740, "y" : 288 },

                { "x" : 170, "y" : 178 },
                { "x" : 399, "y" : 178 },
                { "x" : 630, "y" : 178 },

                { "x" : 280, "y" :  68 },
                { "x" : 520, "y" :  68 },

                { "x" : 170, "y" : 398 },
                { "x" : 399, "y" : 398 },
                { "x" : 630, "y" : 398 },

                { "x" : 280, "y" : 508 },
                { "x" : 520, "y" : 508 }
        ],
    "starting_wheel": 1
}
